AaNew Songs
If You Could Read My Mind - Gordon Lightfoot
The Waiting - Tom Petty
5 Days In May - Blue Rodeo
Aint No Mountain - Marvin Gaye
Alienation - Morning Parade
Caravan - Van Morrison
Cinnamon Girl
The Crystal Ship
Dreams - Cranberries
End of the Line - Wilburys
Heart of gold - Neil Young
Human Highway - Neil Young
Hungry Heart - Bruce Springsteen
I Need You - America
Im Dreaming - Rick Lecksell
Just A Song
LET 'EM IN - Words by McCartney)
The Lion Sleeps Tonight - The Tokens
Nashville (That Was The Night) - Rick Lecksell
No One Is To Blame - Howad Jones
The Rising - Bruce Springsteen
Shout - Tears For Fears
Sunlight Thats The Way She Feels - Jessie Colin Young
Tight Rope - Leon Russell
Tin Man - America
Under The Milky Way - The Church User 58-1 SGT Fr Horn
Victim of Love - Eagles
Vitamin C Song - Rick Lecksell
Watching The Wheels - Beatles/John Lennon
We Just Disagree - Dave Mason
Witchy Woman
You Can Do Magic - America
Train Leaves Hear This Morning - Eagles
Hickory Wind - Gram Parsons & Bob Buchanan 68
This Old Heart of Mine - Rod Stewart
Hitch A Ride - Boston
For Free - Joni Mitchel/ David Crosby Version
Boots Of Spanish Leather - Bob Dylan
Dark Star - CSN
Telephone Line - Jeff Lynne ELO
Strange Magic - Jeff Lynne ELO
Spirit in the Sky - Norman Greenbaum
Turn Turn Turn - The Byrds
Together Again - Buck Owens/Graham Parsons
Wild Horses
Go Now - The Moody Blues
Dig a Pony - Beatles - Roof Top
Traveling Alone - Jason Isabell
