New Songs
All Right Now - Free
All You Need is Love - Beatles
Badge
Best of My Love - Eagles
Bring it on Home - Sam Cooke
Can't You See - Marshall Tucker
Chain Gang - Pretenders
Cherry, Cherry - Neil Diamond
Crazy Love - Poco
Crossroads - Cream
Don't Let Me Down - Beatles
Dreams - Molly Hatchet
Drift Away - Dobie Gray
Dust in the Wind - Kansas
Evil Ways - Santana
For What It's Worth
Gold Dust Woman
Hold On/Your Move - Triumph/Yes
I Can't Tell You Why - Eagles
Keep On Rockin' Me Baby - Steve Miller
Landslide - Fleetwood Mac
Let It Be - Beatles
Lucky Man - ELP
Lyin Eyes - Eagles
Melt With You - Modern English
Moondance - Van Morrison
Mrs. Robinson - Simon and Garfunkel
My Back Pages
One of These Nights - Eagles
Our House - Crosby, Stills, Nash and Young
Panama Red
Pink Houses - John Cougar
Ramblin' Man - Allman Brothers
Refugee - Tom Petty
Sandman - America
Seagull
Something - Beatles
Southern Cross
Space Oddity - David Bowie
Stray Cat Strut - Stray Cats
Stuck in the Middle With You - Stealers Wheel
Sweet Caroline - Neil Diamond
Take It Easy - Eagles
Taking it to the Streets - Doobie Brothers
Tequila Sunrise - Eagles
The Weight
Turn the Page - Bob Segar
Under the Milky Way - The Church
Wagon Wheel - Darius Rucker
What I've Already Heard - Mike Fraser
Wild World - Cat Stevens
Wish You Were Here - Pink Floyd
You're So Vain - Carly Simon
